+++++++++++++++++++++++++
+0                    Aa+
+                       +
+                       +
+                       +
+                       +
+                       +
+++++++++++++++++++++++++
