++++++++++++
+0A       a+
+ B       b+
+ C       c+
+ D       d+
+ E       e+
+ F       f+
+ G       g+
+ H       h+
+ L       l+
+ J       j+
++++++++++++
